-- EN-RU vocabulary file for the WORD SHOT game http://undrev.com/wordshot/
-- Contributors/credits: Undrev, ...
--
-- Some statistics (word's length : count; total words)
-- 3 :  198
-- 4 :  198
-- 5 :  198
-- 6 :  182
-- 7 :  163
-- 8 :  155
-- 9 :  157
-- 10 :  133
-- 11 :  118
-- 12 :  104
-- 13 :  84
-- TOTAL:  1690

abbreviation = аббревиатура
ability = способность
absence = отсутствие
absolution = отпущение грехов
academy = академия
acceleration = ускорение
acceptance = принятие
accessibility = доступность
accommodation = размещение, жильё
accompanist = аккомпаниатор
account = счёт
accumulation = накопление
accuracy = точность
achievement = достижение, успех
acquaintance = знакомство, знакомый
acquiescence = молчаливое согласие
acrobat = акробат
acrobatics = акробатика
act = акт, закон
action = действие, поступок
activity = деятельность
actress = актриса
adaptability = приспособляемость
adaptation = адаптация
address = адрес, обращение
adjustment = регулировка, настройка
administrator = администратор
admiral = адмирал
advance = аванс
advantage = преимущество
advertisement = реклама
advice = совет
aerodynamics = аэродинамика
aesthete = эстет
aesthetics = эстетика
age = возраст
agreement = соглашение
agriculturist = агроном
aid = помощь
aim = цель, намерение
air = воздух
aircraft = самолёт
airplane = аэроплан
airport = аэропорт
algebra = алгебра
allegiance = верность
allegory = иносказание
alliance = альянс, союз
allocation = распределение
ally = союзник
almanac = альманах
alphabet = алфавит
alteration = изменение
altitude = высота
alumnus = воспитанник, выпускник
amateur = любитель
ambassador = посол
ambition = честолюбие
amortization = изнашиваемость
amplification = усиление, расширение
analogy = аналогия, сходство
analysis = анализ
anarchy = анархия
anatomy = анатомия
ancestor = предок
announcement = анонс, объявление
anomaly = аномалия
answer = ответ
ant = муравей
antagonism = антагонизм, противоборство
antenna = антенна
anthropology = антропология
anticipation = предвкушение
apex = верхушка
apology = извинение
apparel = одежда, наряд
appeal = обращение, призыв
appearance = появление, внешний вид
appetite = аппетит
applause = аплодисменты
appreciation = признательность
apprentice = подмастерье, ученик
approach = подход, способ
approval = одобрение, утверждение
apricot = абрикос
aqualung = акваланг
aquarium = аквариум
arc = дуга
architecture = архитектура
area = область, площадь
argument = довод, аргумент
arithmetic = арифметика
arm = рука
army = армия
arrangement = расположение, размещение
arrival = прибытие
arsenal = арсенал
art = искусство
article = статья, артикль
assembly = ассамблея, собрание
assignment = назначение, задание
assimilation = усвоение, ассимиляция
assistance = содействие, помощь
assumption = предположение
asterisk = звёздочка
astonishment = удивление, изумление
athlete = атлет, спортсмен
atmosphere = атмосфера
atom = атом
attempt = попытка
attention = внимание
attitude = отношение, подход
attraction = притяжение
aunt = тётя
authority = власть, авторитет
authorization = разрешение, одобрение
autobiography = автобиография
automation = автоматизация, автоматика
automobile = автомобиль
autumn = осень
aviator = лётчик
axe = топор
axis = ось

baby = младенец
bachelor = холостяк, бакалавр
back = спина, спинка
background = фон, основа
bag = сумка
bait = приманка
balance = равновесие, баланс
ball = шар, мяч
band = полоса, группа
bank = банк, берег
bar = бар, брусок
barn = амбар, сарай
base = база
basement = подвал
basis = основа
bat = бита, летучая мышь
bath = ванна
battery = батарея
battleground = поле боя
bay = бухта, залив
beam = пучок лучей
bean = фасоль
bear = медведь
bed = кровать, постель
bee = пчела
beet = свекла
beginning = начало
behavior = поведение
belief = убеждение, верование
bell = колокол, колокольчик
belongings = вещи, пожитки
belt = пояс, ремень
benefactor = благодетель
benefit = выгода
bet = пари
bewilderment = недоумение
bib = слюнявчик, детский нагрудник
bibliography = библиография
bike = велосипед
bilberry = черника
bill = счёт
bird = птица
birth = рождение
birthday = день рождения
bit = кусочек
bite = укус
blackberry = ежевика
blacksmith = кузнец
blame = обвинение, вина
blizzard = вьюга, метель
block = блок
bloodhound = ищейка
board = доска
boat = лодка
body = тело
bodybuilding = культуризм
bone = кость
book = книга
bookcase = книжный шкаф
bookkeeper = бухгалтер
bookworm = книжный червь
boot = сапог, ботинок
border = граница
boss = босс, шеф
bottom = дно, низ
bow = лук, смычок
bowl = чаша, кубок
box = коробка
boy = мальчик
brain = мозг
branch = филиал, ветвь
bread = хлеб
break = перерыв
breakfast = завтрак
breakthrough = прорыв
breakwater = волнорез
breath = дыхание
bridesmaid = подружка невесты
bridge = мост
brilliance = блеск, великолепие
broadcasting = радиовещание, трансляция
brochure = брошюра
brother = брат
brush = щётка
bud = бутон
bug = жук
building = здание
bull = бык
bun = булочка, плюшка
bus = автобус
bush = куст
business = бизнес
butter = масло
buy = покупка
buzz = жужжание

calendar = календарь
call = вызов
camouflage = камуфляж, маскировка
campaign = кампания
can = бидон, банка
cancellation = отмена, аннулирование
cap = кепка
capacity = вместимость
capital = столица
car = автомобиль, машина
card = карточка
care = забота, уход
caricature = карикатура
carnival = карнавал
case = случай, чехол
cat = кот
category = категория
cauldron = котёл
cause = причина, повод
center = центр
century = век, столетие
challenge = проблема
champion = чемпион, победитель
chance = шанс, случай
chandelier = люстра
change = изменение, перемена
character = характер, персонаж
charge = плата, заряд
chatterbox = болтун
check = проверка
cheek = щека
cheque = чек
chief = шеф
child = ребёнок
children = дети
chin = подбородок
choice = выбор
church = церковь
cinderella = золушка
cinema = кинотеатр
circle = круг, окружность
circumference = окружность
circumstance = обстоятельство
city = город
civilization = цивилизация
claim = претензия
class = класс
classroom = класс, классная комната
clothes = одежда
club = клуб
clue = подсказка
coat = пальто
cocktail = коктейль
cod = треска
coffee = кофе
cog = зубец
collaboration = сотрудничество
collection = коллекция
colonization = колонизация
color = цвет
combination = сочетание, комбинация
comfort = комфорт
command = команда
comment = комментарий, замечание
commerce = коммерция
commitment = обязательство
communication = связь, коммуникация
community = сообщество
company = компания
comparison = сравнение
compassion = сострадание
compatibility = совместимость
compensation = возмещение, компенсация
complaint = жалоба
completeness = законченность, полнота
complication = сложность
composer = композитор
comprehension = постижение, понимание
compromise = компромисс
computer = компьютер
concentration = концентрация, сосредоточенность
concern = обеспокоенность
conclusion = вывод, умозаключение
concrete = бетон
condescension = снисходительность
condition = условие
confectioner = кондитер
confectionery = кондитерская
confederation = конфедерация
confession = признание, исповедь
confidence = уверенность
configuration = конфигурация
confirmation = подтверждение
conflict = конфликт
confrontation = конфронтация, противоборство
congregation = собрание
connection = соединение, связь
consciousness = сознание
conservation = сохранение, консервация
conservatory = консерватория
consideration = рассмотрение, соображение
consolidation = консолидация, укрепление
constellation = созвездие
constitution = конституция
construction = строительство, стройка
consultant = консультант
consultation = консультация
consumer = потребитель
contact = контакт, соприкосновение
container = контейнер
contemplation = созерцание
content = содержание
contradiction = противоречие
contrast = контраст, различие
contravention = нарушение
control = контроль, управление
conversation = разговор, беседа
conviction = убеждение
cop = полицейский
copy = копия
corner = угол
cornucopia = рог изобилия
correction = поправка, исправление
correspondent = корреспондент
corroboration = подтверждение
cost = стоимость
cot = детская кроватка
counsellor = советник
counter = счётчик
counterattack = контратака
country = страна
couple = пара
course = курс
cover = покрытие, обложка
cow = корова
creature = создание, творение
criticism = критика
cross = крест
crowd = толпа
cry = плач, крик
cryptography = криптография
cub = детёныш, новичок
cud = жвачка
cue = кий, намёк
culture = культура
cup = чашка, кубок
curriculum = учебный план
custom = обычай, традиция
cut = порез

dad = папа
daisy = маргаритка
damage = повреждение, ущерб
dance = танец
danger = опасность
darkness = темнота, мрак
date = дата
daughter = дочь
day = день
deadlock = тупик
deal = сделка
decision = решение
declaration = декларация
decomposition = разложение, распад
decoration = украшение, убранство
decoy = приманка
dedication = преданность, самоотверженность
definition = определение
degree = градус, степень
delay = задержка, промедление
delegation = делегация
demolition = снос
demonstration = демонстрация
den = логово, берлога
department = отдел, ведомство
dependency = зависимость
depth = глубина
descendant = потомок
description = описание
design = дизайн, конструкция
designer = дизайнер, проектировщик
detail = деталь
determination = определение, решительность
dew = роса
dialogue = диалог
diameter = диаметр
diary = дневник
dictionary = словарь
difference = разница, различие
difficulty = трудность
dig = раскопки
digit = цифра
din = грохот, шум
dinner = обед
dip = погружение
diplomat = дипломат
direction = направление
director = директор, начальник
disappearance = исчезновение
discipline = дисциплина
disconnection = размыкание, отключение
discovery = открытие
discussion = дискуссия
dish = блюдо
dispensation = распределение, раздача
displacement = вытеснение, сдвиг
display = показ, дисплей
disproportion = диспропорция, непропорциональность
dissertation = диссертация
dissimilarity = несхожесть, различие
distance = расстояние, дистанция
distribution = распространение
district = район, округ
divan = диван
diver = водолаз
division = деление, дивизия
doctor = врач, доктор
document = документ
dolly = куколка
domination = господство
donation = пожертвование
door = дверь
doorstep = порог
dot = точка
doubt = сомнение
dough = тесто
doughnut = пончик
dozen = дюжина
draft = черновик
drawing = рисование, рисунок
dream = мечта
dress = платье
drink = напиток
drive = езда
drop = капля
drove = стадо
dummy = манекен, муляж
duration = длительность, продолжительность
duty = обязанность

eagle = орёл
ear = ухо
earth = земля
earthquake = землетрясение
edge = край, кромка
education = образование
effect = эффект
effervescence = вскипание
efficiency = эффективность
efflorescence = цветение
effort = усилие
egg = яйцо
elbow = локоть
elegance = элегантность, изящество
elephant = слон
elevator = лифт, подъёмник
elf = эльф
elk = лось
elm = вяз
embarrassment = смущение
ember = зола, угли
emotion = эмоция
emphasis = акцент, внимание
employment = трудоустройство, занятость
encouragement = ободрение, поощрение
encyclopedia = энциклопедия
end = конец
enemy = враг
energy = энергия
engineer = инженер
enlightenment = просветление
entanglement = запутанность
entertainment = развлечение
enthusiast = энтузиаст
entrance = вход
entrepreneur = предприниматель
entry = вхождение, вступление
envelope = конверт
environment = окружающая среда, окружение
envoy = посланец
epigraph = эпиграф
epoch = эпоха
equality = равенство, равноправие
equation = уравнение
equipment = оборудование, оснащение
era = эра
error = ошибка, заблуждение
escape = побег
essay = очерк, эссе
establishment = учреждение, истеблишмент
estimate = смета, оценка
eternity = вечность
evacuation = эвакуация
eve = канун
evening = вечер
event = событие
evidence = доказательство
exaggeration = преувеличение
exam = экзамен
example = пример
excellence = превосходство
exchange = обмен
excitement = волнение
excuse = извинение
exercise = упражнение
exhibition = выставка
exit = выход
experience = опыт, стаж
experiment = эксперимент
explanation = объяснение
exploration = исследование
expression = выражение
extraction = извлечение
exultation = ликование
eye = глаз

face = лицо
facilitation = облегчение
fact = факт
factory = фабрика
faithfulness = верность
family = семья
fan = вентилятор, болельщик
fashion = мода
father = отец
fatherland = отчизна, отечество
fay = фея
fear = страх, боязнь
fearlessness = бесстрашие, неустрашимость
feature = особенность
federation = федерация
fee = гонорар, плата
feeling = ощущение, чувство
female = самка
fence = забор
fermentation = ферментация
festival = фестиваль
fib = выдумка
field = поле
fig = инжир, смоковница
figure = фигура, цифра
file = файл
film = фильм
fin = плавник
finger = палец
fir = ель, пихта
fire = огонь
fireball = шаровая молния
firewood = дрова
flagship = флагман, флагманский корабль
flamingo = фламинго
flight = полёт
floor = этаж, пол
floriculture = цветоводство
flow = поток
fly = муха
foe = противник, враг
fog = туман
food = еда
foot = нога, ступня
footstep = шаг
force = сила
forecast = прогноз
forefinger = указательный палец
foreground = передний план, авансцена
forehead = лоб
forerunner = предвестник, предтеча
fork = вилка
form = форма, вид
fortification = фортификация, укрепление
fortress = крепость
foundation = фундамент, основание
fountain = фонтан
fox = лиса
fragment = фрагмент
fragmentation = фрагментация, раздробленность
frame = рамка, каркас
freedom = свобода
friend = друг
friendship = дружба
frontier = граница
fun = веселье
fur = мех
furniture = мебель
future = будущее

gallery = галерея
game = игра
gap = брешь
gas = газ, бензин
gastronomy = кулинария
gate = ворота
gem = самоцвет, драгоценность
generation = поколение
geographer = географ
geology = геология
geometry = геометрия
gesticulation = жестикуляция
gesture = жест
getaway = бегство
gift = подарок
gig = кабриолет, шоу
giraffe = жираф
glass = стекло, стакан
glimpse = проблеск
glitter = блеск
glorification = прославление
glossary = словарь терминов
goodness = добродетель, доброта
goodwill = доброжелательность, добрая воля
government = правительство
grade = степень, класс
grammar = грамматика
granddaughter = внучка
grandma = бабушка
grandpa = дедушка
grandson = внук
grapple = схватка, захват
gravity = сила тяжести
greeting = приветствие
ground = земля
group = группа
grumble = ворчание, ропот
guaranty = гарантия
guard = охрана
guardian = страж, хранитель
guardianship = попечительство, опека
guess = догадка, предположение
guide = гид
gum = десна, жевательная резинка
gun = ружьё, пушка
gut = нутро, кишечник
guy = парень
gym = спортзал, гимнастика

habit = привычка, обычай
hair = волосы
hairdresser = парикмахер
half = половина
hallucination = галлюцинация
hammock = гамак
hamster = хомяк
hand = рука
handbag = сумочка
handful = пригоршня, горсть
handicraft = рукоделие, ремесло
handshake = рукопожатие
happening = явление, событие
happiness = счастье
harbinger = предвестник
hardihood = дерзость, отвага
harmony = гармония
harpoon = гарпун, острога
hat = шляпа
hay = сено
head = голова
health = здоровье
heart = сердце
heat = жара
hedgehog = ёж
height = высота, рост
heiress = наследница
helicopter = вертолёт
hem = рубец, кайма
hemisphere = полушарие
hen = курица
herbarium = гербарий
heritage = наследие, достояние
hermitage = скит, жилище отшельника
hesitation = сомнение, нерешительность
hierarchy = иерархия
hieroglyph = иероглиф
highlander = горец
highway = шоссе
hip = бедро
hippodrome = ипподром
hippopotamus = гиппопотам, бегемот
history = история
hit = удар, попадание
hob = конфорка
hobgoblin = домовой
hog = боров, свинья
hold = владение, захват
hole = дыра
holiday = праздник, отпуск
home = дом
honesty = честность
honeycomb = медовые соты
honeymoon = медовый месяц
hop = скачок, прыжок
hope = надежда
horizon = горизонт
horsepower = лошадиная сила, мощь
horseshoe = подкова
hospital = больница
hospitality = гостеприимство
hostess = хозяйка, стюардесса
hour = час
house = дом
household = домовладение, семейство
housekeeping = домашнее хозяйство
hub = узел, средоточие
hue = оттенок, тон
hug = объятие
hum = гул, гудение
human = человек
humanity = человечество
hurricane = ураган
husband = муж
hut = хижина, лачуга
hydrogen = водород
hydroplane = гидросамолёт, глиссер
hygiene = гигиена
hypothesis = гипотеза

ice = лёд
iceberg = айсберг
idea = идея
idealist = идеалист
ignoramus = невежда, неуч
ignorance = невежество, неведение
illumination = освещение
illusion = иллюзия
illustration = иллюстрация
image = образ, имидж
imagination = воображение
imitation = подражание, имитация
immortality = бессмертие
immutability = неизменность
impalpability = неосязаемость
impatience = нетерпение
impetuosity = стремительность, импульсивность
importance = важность, значительность
importunity = назойливость
impression = впечатление
improvement = улучшение, усовершенствование
impulse = импульс, толчок
inattention = невнимательность
incarnation = воплощение
inception = зарождение, начало
incertitude = неуверенность
incident = происшествие
inclination = склонность, уклон
incognito = инкогнито, под чужим именем
inconvenience = неудобство, беспокойство
incorporation = объединение, корпорация
increase = возрастание, рост
incredulity = недоверие
incubator = инкубатор
indemnity = возмещение, компенсация
independence = независимость, самостоятельность
indicator = индикатор
indifference = безразличие, равнодушие
individual = индивидуум, личность
individualism = индивидуализм
individuality = индивидуальность, личность
induction = индукция
industry = отрасль, индустрия
inertia = инерция
infection = заражение, инфекция
infinity = бесконечность
inflation = надувание, инфляция
influence = влияние, воздействие
information = информация
infringement = нарушение
ingenuity = смекалка, изобретательность
inhabitant = житель, обитатель
inheritance = наследство, наследственность
inheritor = наследник, преемник
initiator = инициатор, зачинщик
injustice = несправедливость
ink = чернила
inn = гостиница, постоялый двор
innocence = невинность, невиновность
inquiry = запрос, расследование
insight = проницательность, понимание
insinuation = инсинуация, намёк
insolence = наглость
insouciance = беззаботность, безмятежность
inspector = инспектор, контролёр
inspiration = вдохновение
instability = неустойчивость, непостоянство
installation = установка, устройство
institution = учреждение, ведомство
instruction = инструкция, инструктаж
instrument = инструмент, прибор
insurance = страхование
integrity = целостность, честность
intellect = интеллект, ум
intention = намерение, замысел
interest = интерес
interpreter = переводчик
interruption = перерыв
interview = интервью, беседа
intrepidity = неустрашимость, отвага
introduction = введение, представление
introspection = самоанализ, самонаблюдение
intuition = интуиция
invention = изобретение
inventory = инвентарь, запас
investigation = расследование, следствие
investigator = исследователь, испытатель
investment = инвестиция, вклад
invitation = приглашение
ion = ион
isle = остров
isolation = изоляция, уединение
issue = разногласие, выпуск
ivy = плющ

jab = укол, толчок
jag = зубец
jam = затор, джем
janitor = привратник, дворник
jar = кувшин, банка
jasmine = жасмин
jaw = челюсть, пасть
jay = сойка
jeopardy = опасность, риск
jet = струя, реактивный самолет
jeweller = ювелир
jewelry = драгоценность, украшение
job = работа
joke = шутка
journal = журнал, дневник
journey = путешествие, поездка
joviality = общительность
joy = радость
jubilee = юбилей, юбиляр
judge = судья
judgement = суждение, приговор
juggler = жонглёр, плут
juice = сок
jump = прыжок
juniper = можжевельник
justice = правосудие, справедливость
justification = оправдание
jut = выступ
juxtaposition = сопоставление

kaleidoscope = калейдоскоп
kangaroo = кенгуру
keeper = хранитель, сторож
keg = бочонок
kernel = ядро, зерно
ketchup = кетчуп
kettle = чайник
key = ключ, клавиша
keyboard = клавиатура
keyhole = замочная скважина
kick = пинок, удар
kid = пацан, ребёнок
kidney = почка
kin = род, родня
kind = сорт, вид
kindergarten = детский сад
kingdom = королевство
kit = снаряжение, комплект
kitchen = кухня
kitten = котёнок
knight = рыцарь
knighthood = рыцарство
knock = стук
knowledge = знание
knuckle = шарнир, сустав пальца

label = ярлык, этикетка
laboratory = лаборатория
labyrinth = лабиринт
lad = юноша, парень
ladder = стремянка, лестница
lag = отставание, задержка
lagoon = лагуна
land = земля, суша
landowner = землевладелец
landscape = ландшафт, пейзаж
landslide = оползень, обвал
language = язык
lap = круг, заезд
laugh = смех
law = закон
lea = луг, поле
leader = лидер, вождь
league = лига, союз
leg = нога, ножка
legacy = наследство
legend = легенда
legislation = законодательство
lemonade = лимонад
length = длина, расстояние
lesson = урок
letter = буква, письмо
level = уровень
liberation = освобождение
librarian = библиотекарь
lid = веко, крышка
lie = ложь, обман
life = жизнь
lift = лифт
light = свет, лампа
lighthouse = маяк
lightning = молния
limit = предел, граница
line = линия, очередь
linguistics = языковедение, лингвистика
lip = губа, кромка
lipstick = губная помада
list = список
literature = литература
lizard = ящерица
lock = замок, локон
locket = медальон, кулон
locksmith = слесарь
log = бревно, журнал
longitude = долгота
lot = жребий, участь
loudspeaker = громкоговоритель
lounge = фойе, вестибюль
love = любовь
luck = удача, случай
luggage = багаж
lunch = обед, ленч
luxury = роскошь

machination = махинация, козни
machine = машина, механизм
maelstrom = водоворот, вихрь
magnanimity = великодушие
magnet = магнит
magnificence = великолепие, роскошь
magnitude = значимость, важность
mail = почта
maintenance = эксплуатация, техобслуживание
majority = большинство
male = самец
man = мужчина
management = управление
manifestation = манифестация, проявление
manner = манера, способ
manoeuvre = манёвр
manual = справочник, руководство
manufacture = производство, изготовление
manuscript = рукопись
map = карта
marble = мрамор
march = марш
mark = метка, клеймо
market = рынок
marmalade = повидло, варенье
marvel = чудо, диво
mascot = талисман, символ
mass = масса, множество
master = хозяин, мастер
masterpiece = шедевр
mat = коврик, циновка
match = спичка, матч
material = материал
mathematics = математика
matter = дело, вопрос
may = май
meadow = луг
meal = еда
meaning = смысл, значение
measure = мера, мероприятие
measurement = измерение, замер
mechanics = механика
meeting = собрание, встреча
melancholy = уныние, грусть
melody = мелодия
member = участник, сотрудник
memoir = мемуары
memory = память
menace = угроза, опасность
mentality = мышление, склад ума
merchandise = атрибутика, товар
mess = беспорядок
message = сообщение
messenger = вестник, курьер
metaphysics = метафизика
meteor = метеор
meteorology = метеорология
method = метод, способ
methodology = методология
mettle = характер, пыл
mew = мяуканье
microbiology = микробиология
microphone = микрофон
midday = полдень
middle = середина
midsummer = середина лета
milestone = веха, верстовой столб
millennium = тысячелетие
miller = мельник
millionaire = миллионер
mind = ум, мнение
mine = шахта, мина
minute = минута
mirage = мираж
mirror = зеркало
miss = промах, неудача
mistake = ошибка
mister = господин, мистер
mitten = рукавица
mix = смесь, сочетание
mixture = смешивание, смесь
mob = сборище, шайка
model = модель, макет
moderator = арбитр, ведущий
modification = изменение, модификация
moment = миг, момент
monastery = монастырь
money = деньги
month = месяц
moo = мычание
mood = настроение
moon = луна
moonlight = лунный свет
mop = швабра, копна
morning = утро
mother = мать
motion = движение
motive = мотив, повод
mousetrap = мышеловка
moustache = усы
mouth = рот
move = ход
movement = передвижение
mow = стог, сеновал
mud = слякоть, грязь
muffin = сдоба, пирожок
mug = кружка, рожа
multitude = множество, масса
munificence = щедрость
muscle = мускул, мышца
music = музыка
mystery = тайна, загадка

name = имя
nap = дремота
narration = повествование, изложение
narrative = повесть, рассказ
nation = народ
nature = природа
navigator = штурман, мореход
neck = шея, горлышко
needle = игла, спица
negotiation = переговоры
neighbor = сосед
neighborhood = соседство
nephew = племянник
nerve = нерв
net = сеть, паутина
neutrality = нейтралитет
news = новость, известие
newspaper = газета
nib = острие, перо
night = ночь
nightingale = соловей
nightmare = кошмар
nip = щипок, укус
nipper = щипцы, клещи
nob = шишка, высокопоставленное лицо
nod = кивок, поклон
noise = шум, грохот
nonsense = ерунда, бессмыслица
noon = полдень
nose = нос
note = записка, нота
notice = афиша, объявление
notification = извещение
novice = новичок
nozzle = сопло, наконечник
number = число, количество
nun = монашка
nurse = медсестра
nut = орех
nutrition = питание

oak = дуб
oar = весло, гребец
oat = овёс
object = предмет, объект
objection = возражение, протест
objective = цель, задача
objurgation = упрёк
obligation = обязательство, обязанность
obscurity = безвестность, мрак
observation = наблюдение
observatory = обсерватория
obsession = одержимость, наваждение
obstruction = препятствие
occasion = случай, повод
ocean = океан
oddity = странность, курьёз
offer = предложение
office = контора
offspring = отпрыск, потомок
oil = масло, нефть
onrush = натиск
onslaught = нападение, штурм
operation = операция, действие
opinion = мнение
opponent = оппонент, противник
opportunity = возможность
optimization = оптимизация
option = вариант, выбор
oracle = предсказатель, оракул
orange = апельсин
orchestra = оркестр
order = порядок, приказ
ore = руда
organization = организация
origin = происхождение, источник
originality = подлинность, оригинальность
orthography = орфография
oscillation = колебание, осцилляция
outfit = снаряжение, экипировка
owl = сова
oxygen = кислород
oyster = устрица

pacification = умиротворение
pad = подкладка, подушечка
pain = боль
pair = пара
pal = приятель
paleontology = палеонтология
pan = сковорода, кастрюля
paper = бумага
parachute = парашют
paragraph = параграф, абзац
parenthesis = скобка
part = часть, доля
participant = участник
particularity = особенность, специфика
partner = партнёр, напарник
partnership = партнёрство, сотрудничество
party = партия, вечеринка
passage = проход, пассаж
passenger = пассажир
patchwork = мешанина, лоскутное одеяло
path = тропинка, дорожка
pathfinder = следопыт, проводник
patronage = шефство, покровительство
pattern = шаблон, модель
pause = пауза
paw = лапа
payment = платёж, оплата
pea = горох, горошина
peace = мир
peculiarity = странность, особенность
peg = вешалка, крючок
pen = ручка, перо
pencil = карандаш
peninsula = полуостров
people = люди
percentage = процент
peregrination = странствие
perfection = совершенство
perforation = перфорация, отверстие
performance = представление, показатели работы
period = период
permission = разрешение, позволение
perseverance = настойчивость, упорство
persistence = постоянство, упорство
person = личность, человек
personality = личность
personnel = персонал, кадры
perspective = перспектива, ракурс
pertinacity = упрямство
pet = любимец, домашнее животное
petrol = бензин
petroleum = нефть
pharmacology = фармакология
philanthropy = филантропия, благотворительность
philologist = филолог, языковед
phone = телефон
photography = фотография, фотосъёмка
picture = картина, рисунок
pie = пирог
piece = кусок, часть
pile = куча, кипа
pin = булавка, кнопка
pineapple = ананас
pip = косточка, зёрнышко
pipe = труба, трубопровод
pistachio = фисташка
pit = яма, котлован
pity = жалость
place = место, площадь
placidity = спокойствие, безмятежность
plan = план
plant = растение, завод
plastic = пластмасса
plate = тарелка
platform = платформа, трибуна
play = пьеса, игра
plaything = игрушка
pleasure = удовольствие
ply = сгиб, слой
pocket = карман
pod = стручок, кокон
point = точка, место
poison = яд
police = полиция
politics = политика
pollution = загрязнение
pool = бассейн, лужа
port = порт
portfolio = портфель, портфолио
position = расположение, место
positiveness = позитивность
possession = владение, обладание
possibility = возможность, вероятность
post = почта
pot = горшок
power = сила
practice = практика
precognition = предвидение
preconception = предубеждение, предрассудок
predecessor = предшественник
pregnancy = беременность
premeditation = умысел, преднамеренность
premonition = предчувствие
preparation = подготовка, приготовление
preponderance = превосходство, перевес
present = подарок
presentation = представление, презентация
president = президент, председатель
press = пресса
pressure = давление, воздействие
presumption = предположение, допущение
price = цена
pride = гордость
principle = принцип
print = печать
priority = приоритет, преимущество
prize = приз, премия
probability = вероятность
problem = проблема
process = процесс
proclamation = провозглашение
production = изготовление, продукция
productivity = производительность
professorship = профессорство, профессура
proficiency = сноровка, умение
profit = прибыль
progress = прогресс
prohibition = запрет
project = проект
promise = обещание
pronouncement = официальное заявление
pronunciation = произношение
proof = доказательство, подтверждение
proposition = утверждение
protection = защита, охрана
psychologist = психолог
pub = трактир, кабак
public = публика, общественность
publication = публикация, издание
pug = мопс
pun = каламбур
punishment = наказание, кара
pup = щенок
pupil = ученик
purpose = намерение, цель

qualification = квалификация, ценз
quality = качество, сорт
quantity = количество
quarter = четверть, квартал
quartermaster = интендант, квартирмейстер
quartz = кварц
queen = королева
query = запрос
quest = поиск приключений
question = вопрос
questionnaire = анкета, вопросник
quicksand = зыбучий песок
quicksilver = ртуть
quiet = безмолвие, тишина
quill = перо
quilt = одеяло
quirk = каламбур, причуда
quiver = колчан, дрожь
quiz = викторина, опрос
quota = квота, доля
quotation = котировка, цитирование
quote = цитата, кавычка

race = раса, гонка
radiation = излучение, радиация
radio = радио
rag = тряпка, отрепье
rain = дождь
ram = баран, таран
range = ряд, линия
rank = чин, звание
raspberry = малина
rat = крыса
rate = ставка, показатель
rationality = разумность, рациональность
ray = луч, скат
reaction = реакция
realization = осуществление, реализация
reason = причина, рассудок
reception = регистратура, приём
receptionist = секретарь
recipient = получатель
recognition = узнаваемость, признание
record = рекорд, запись
recovery = выздоровление, восстановление
rectification = исправление, очищение
reduction = сокращение, понижение
reformation = реформа, преобразование
refreshment = буфет, закуски
refrigerator = холодильник
regard = уважение, внимание
region = область, регион
registration = регистрация
reincarnation = перевоплощение
reinforcement = укрепление, усиление
rejection = отклонение
relation = отношение, связь
relationship = родство, взаимоотношение
relative = родственник
relaxation = расслабление, отдых
reliability = надёжность, прочность
relief = облегчение
remainder = остаток
remark = примечание, ремарка
reminiscence = воспоминание, мемуары
replacement = замена
reply = ответ
report = отчёт, доклад
reproduction = воспроизведение
requirement = требование, условие
residence = резиденция, место жительства
respect = уважение
respiration = дыхание
rest = отдых, остаток
restoration = реставрация, восстановление
restriction = ограничение
result = результат
retrospection = ретроспектива, размышления о прошлом
reverberation = реверберация, отзвук
rib = ребро, жилка
rig = оснастка, снаряжение
right = право, правда
rim = оправа, ободок
ring = кольцо, круг
risk = риск
road = дорога
rod = прут, стержень
roe = косуля
roof = крыша
room = комната
row = ряд, линия
rubbish = мусор, ерунда
rug = плед, ковёр
rule = правило
run = бег
rush = спешка, суета
rye = рожь

sacrifice = жертва, жертвоприношение
safe = сейф
safeguard = охрана
safety = безопасность, сохранность
sale = продажа, распродажа
salvation = спасение
sandglass = песочные часы
satisfaction = сатисфакция, удовлетворение
sax = саксофон
scale = шкала, масштаб
scaremonger = паникёр
scene = сцена, пейзаж
schedule = расписание, список
scheme = схема, план
scholarship = эрудиция, учёность
school = школа
science = наука
score = счёт
scrap = клочок, кусочек
scream = крик
sculpture = скульптура
sea = море
search = поиск, розыск
season = сезон
seat = сиденье, место
second = секунда
secret = секрет, тайна
section = секция
sense = чувство, смысл
sensibility = чувствительность
sentence = изречение, приговор
service = служба, сервис
set = набор, комплект
shade = оттенок
shadow = тень
shame = стыд
shape = форма, очертание
share = доля, часть
shelter = убежище, приют
shock = шок, потрясение
shop = магазин
shoulder = плечо
shout = крик
show = шоу, показ
side = сторона
sight = зрение, взгляд
sign = знак, символ
signification = значение, смысл
singularity = сингулярность, своеобразие
sister = сестра
situation = ситуация, положение
size = размер
skill = навык, умение
skin = кожа, кожура
skirt = юбка
sky = небо, небеса
sleep = сон
slice = ломтик
smell = запах, обоняние
smile = улыбка
smoke = дым
snow = снег
software = софт, программное обеспечение
soil = почва, грунт
song = песня
sort = сорт, тип
sound = звук
space = пространство, космос
specification = спецификация, характеристика
speech = речь
speed = скорость
sport = спорт
spot = пятно, место
spring = весна, родник
square = квадрат, площадь
stabilization = стабилизация
stage = стадия, сцена
stamp = штамп, марка
standard = стандарт
star = звезда
start = старт, начало
state = состояние, государство
statement = утверждение, заявление
steam = пар
step = шаг, след
stepbrother = сводный брат
stepdaughter = падчерица
stick = палка, трость
sticker = наклейка
stimulation = поощрение
sting = жало
stockholder = акционер
stocktaking = переучёт, инвентаризация
stone = камень
stop = остановка
store = запас, магазин
storekeeper = кладовщик, лавочник
storm = шторм, гроза
story = история, рассказ
storyteller = сказочник, рассказчик
stratosphere = стратосфера
street = улица
strength = сила, прочность
strike = удар, забастовка
strikebreaker = штрейкбрехер
string = струна, шнурок
study = изучение, кабинет
style = стиль
subject = тема, предмет
subordination = субординация, подчинение
subscription = подписка
substance = вещество, субстанция
substitution = замещение
success = успех, достижение
sufficiency = достаточность, обеспеченность
suggestion = предложение, совет
suit = костюм
summer = лето
summerhouse = беседка
supermarket = супермаркет, крупный магазин
superstition = суеверие, предрассудок
supervision = надзор, наблюдение
surface = поверхность
surprise = удивление, сюрприз
surveillance = наблюдение, надзор
switch = выключатель
system = система

table = стол
talk = беседа, разговор
tap = кран
tape = лента
target = мишень, цель
task = задача, задание
taste = вкус
tax = налог, сбор
team = команда
telephone = телефон
telescope = телескоп
television = телевидение
temper = нрав, характер
temperature = температура
term = срок, термин
test = тест, испытание
thermometer = градусник, термометр
thing = вещь, предмет
thought = мысль, размышление
thumb = большой палец
thunderbolt = удар молнии
thunderstorm = гроза
ticket = билет
time = время
timetable = расписание
tip = кончик, чаевые
today = сегодня
tomorrow = завтра
tone = тон, звук
tongue = язык
tool = инструмент
tooth = зуб
top = вершина, верх
total = итог, сумма
touch = прикосновение, касание
tour = экскурсия, путешествие
town = город
track = тропинка, трек
trade = торговля
tradition = традиция
traffic = движение, транспорт
train = поезд
tranquility = спокойствие
transcription = транскрипция, переписывание
translation = перевод
transmission = передача, пересылка
transport = перевозка, транспорт
trap = ловушка, капкан
travel = путешествие
traveller = путешественник
treatment = лечение
trepidation = трепет, беспокойство
trial = испытание, судопроизводство
trick = хитрость, обман
trigonometry = тригонометрия
trip = поездка, путешествие
trouble = неприятность, беспокойство
trousers = брюки, штаны
trust = доверие
truth = правда
tune = мелодия
turn = поворот, очередь
type = тип, класс

ultimatum = ультиматум
ultramarine = ультрамарин
ultraviolet = ультрафиолет
umbilicus = пупок
umbrella = зонтик
uncle = дядя
undergraduate = старшекурсник, выпускник
underground = метрополитен, подполье
understanding = понимание, соглашение
undertaking = затея, дело
underwear = нижнее бельё
uniform = униформа, форменная одежда
union = союз, объединение
unit = единица, элемент
universe = вселенная
university = университет
uproar = шум, гам
urbanization = урбанизация
urgency = срочность, крайняя необходимость
usage = употребление, использование
utility = польза

vacancy = вакансия, свободное место
vacation = отпуск
vaccine = вакцина
vacuum = вакуум
valley = долина
value = ценность, стоимость
valve = вентиль, клапан
vapor = пар
variant = вариант
variety = разнообразие, множество
vase = ваза
vault = свод, подвал
vegetable = овощ
vegetation = растительность
vehicle = транспорт, машина
vein = вена
velocity = скорость
velvet = бархат
vengeance = месть, возмездие
ventilation = вентиляция
verification = проверка
versatility = многогранность
verse = стих
version = версия
vessel = корабль, сосуд
veterinarian = ветеринар
vibration = вибрация
victory = победа
view = вид, пейзаж
village = деревня
villain = злодей
violin = скрипка
viper = гадюка, змея
virtue = достоинство
vision = видение, зрение
visit = посещение, визит
visitor = посетитель
vocabulary = словарь
vogue = мода
voice = голос
void = пустота
volcano = вулкан
volunteer = доброволец
vow = обет, клятва
voyage = путешествие
vulnerability = уязвимость, слабое место

wage = зарплата
wagon = фургон, телега
waistcoat = жилет
walk = прогулка
wall = стена
wallet = бумажник
wallpaper = обои
war = война
warning = предупреждение, предостережение
warrior = воин, боец
wash = мытьё, стирка
wasp = оса
waste = ущерб, отбросы
watch = бдительность, наручные часы
water = вода
waterfall = водопад
wave = волна, взмах
way = путь, направление
wealth = богатство
weapon = оружие
weather = погода
weathercock = флюгер
web = паутина
wedding = свадьба
week = неделя
weekend = выходные дни
welfare = благополучие
whale = кит
wheat = пшеница
wheel = колесо
whirlpool = водоворот
whistle = свисток
whortleberry = брусника
wife = жена
will = воля, завещание
wind = ветер
window = окно
wing = крыло
winter = зима
wire = проволока, провод
wish = желание
wolf = волк
woman = женщина
word = слово
work = работа
world = мир
worth = стоимость, ценность
writer = писатель

xmas = рождество
xylophone = ксилофон

yacht = яхта
yarn = пряжа, байка
year = год
yell = вопль
yesterday = вчера
youngster = юнец, юноша
youth = молодёжь, юность

zebra = зебра
zephyr = зефир, лёгкий ветерок
zero = ноль
zip = свист, индекс
zipper = застёжка
zodiac = зодиак
zone = зона
zoo = зоопарк
zoology = зоология

