-- RU-EN vocabulary file for the WORD SHOT game http://undrev.com/wordshot/
-- Contributors/credits: Undrev, ...
--
-- Some statistics (word's length : count; total words)
-- 3 :  62
-- 4 :  171
-- 5 :  225
-- 6 :  196
-- 7 :  211
-- 8 :  180
-- 9 :  129
-- 10 :  115
-- 11 :  89
-- 12 :  81
-- 13 :  49
-- TOTAL:  1508

аббревиатура = abbreviation
абрикос = apricot
аванс = advance
автобиография = autobiography
автобус = bus
автоматизация = automation
автомобиль = car, automobile
агроном = agriculturist
адаптация = adaptation
администратор = administrator
адмирал = admiral
адрес = address
айсберг = iceberg
академия = academy
акваланг = aqualung
аквариум = aquarium
аккомпаниатор = accompanist
акробат = acrobat
акробатика = acrobatics
акт = act
актриса = actress
акцент = emphasis
акционер = stockholder
алгебра = algebra
алфавит = alphabet
альманах = almanac
альянс = alliance
амбар = barn
анализ = analysis
аналогия = analogy
ананас = pineapple
анархия = anarchy
анатомия = anatomy
анкета = questionnaire
аномалия = anomaly
анонс = announcement
антагонизм = antagonism
антенна = antenna
антропология = anthropology
апельсин = orange
аплодисменты = applause
аппетит = appetite
арбитр = moderator
арифметика = arithmetic
армия = army
арсенал = arsenal
архитектура = architecture
ассамблея = assembly
атлет = athlete
атмосфера = atmosphere
атом = atom
атрибутика = merchandise
афиша = notice
аэродинамика = aerodynamics
аэроплан = airplane
аэропорт = airport

бабушка = grandma
багаж = luggage
база = base
банк = bank
бар = bar
баран = ram
бархат = velvet
бассейн = pool
батарея = battery
бдительность = watch
бег = run
бегство = getaway
бедро = hip
безвестность = obscurity
беззаботность = insouciance
безмолвие = quiet
безопасность = safety
безразличие = indifference
бензин = petrol
беременность = pregnancy
беседа = talk
беседка = summerhouse
бесконечность = infinity
беспорядок = mess
бессмертие = immortality
бесстрашие = fearlessness
бетон = concrete
библиография = bibliography
библиотекарь = librarian
бидон = can
бизнес = business
билет = ticket
бита = bat
благодетель = benefactor
благополучие = welfare
блеск = brilliance, glitter
блок = block
блюдо = dish
богатство = wealth
болтун = chatterbox
боль = pain
больница = hospital
большинство = majority
боров = hog
босс = boss
бочонок = keg
брат = brother
бревно = log
брешь = gap
брошюра = brochure
брусника = whortleberry
брюки = trousers
будущее = future
буква = letter
булавка = pin
булочка = bun
бумага = paper
бумажник = wallet
бутон = bud
буфет = refreshment
бухгалтер = bookkeeper
бухта = bay
бык = bull

важность = importance
ваза = vase
вакансия = vacancy
вакуум = vacuum
вакцина = vaccine
ванна = bath
вариант = variant, option
введение = introduction
вдохновение = inspiration
век = century
веко = lid
великодушие = magnanimity
великолепие = magnificence
велосипед = bike
вена = vein
вентиль = valve
вентилятор = fan
вентиляция = ventilation
верность = allegiance, faithfulness
вероятность = probability
версия = version
вертолёт = helicopter
верхушка = apex
вершина = top
веселье = fun
весло = oar
весна = spring
вестник = messenger
ветер = wind
ветеринар = veterinarian
веха = milestone
вечер = evening
вечность = eternity
вешалка = peg
вещество = substance
вещи = belongings
вещь = thing
вибрация = vibration
вид = view
видение = vision
викторина = quiz
вилка = fork
вкус = taste
владение = possession, hold
власть = authority
влияние = influence
вместимость = capacity
внимание = attention
внук = grandson
внучка = granddaughter
вода = water
водоворот = whirlpool, maelstrom
водолаз = diver
водопад = waterfall
водород = hydrogen
воздух = air
возмещение = compensation, indemnity
возможность = opportunity, possibility
возражение = objection
возраст = age
возрастание = increase
воин = warrior
война = war
волк = wolf
волна = wave
волнение = excitement
волнорез = breakwater
волосы = hair
воля = will
воображение = imagination
воплощение = incarnation
вопль = yell
вопрос = question
ворота = gate
ворчание = grumble
воспитанник = alumnus
воспоминание = reminiscence
впечатление = impression
враг = enemy
врач = doctor
время = time
вселенная = universe
вскипание = effervescence
вулкан = volcano
вход = entrance
вхождение = entry
вчера = yesterday
выбор = choice
вывод = conclusion
выгода = benefit
выдумка = fib
выздоровление = recovery
вызов = call
выключатель = switch
выражение = expression
высота = height, altitude
выставка = exhibition
выступ = jut
вытеснение = displacement
выход = exit
вьюга = blizzard
вяз = elm

гадюка = viper
газ = gas
газета = newspaper
галерея = gallery
галлюцинация = hallucination
гамак = hammock
гарантия = guaranty
гармония = harmony
гарпун = harpoon
географ = geographer
геология = geology
геометрия = geometry
гербарий = herbarium
гигиена = hygiene
гид = guide
гидросамолёт = hydroplane
гипотеза = hypothesis
гиппопотам = hippopotamus
глаз = eye
глубина = depth
год = year
голова = head
голос = voice
гонорар = fee
гордость = pride
горец = highlander
горизонт = horizon
город = city, town
горох = pea
горшок = pot
господин = mister
господство = domination
гостиница = inn
градус = degree
градусник = thermometer
грамматика = grammar
граница = border, frontier
гроза = thunderstorm
грохот = din
группа = group
губа = lip
гул = hum

давление = pressure
дата = date
дверь = door
движение = motion, traffic
дедушка = grandpa
действие = action
декларация = declaration
делегация = delegation
деление = division
дело = matter
демонстрация = demonstration
день = day
деньги = money
деревня = village
дерзость = hardihood
десна = gum
деталь = detail
дети = children
детёныш = cub
деятельность = activity
диалог = dialogue
диаметр = diameter
диван = divan
дизайн = design
дизайнер = designer
дипломат = diplomat
директор = director
дискуссия = discussion
диспропорция = disproportion
диссертация = dissertation
дисциплина = discipline
длина = length
длительность = duration
дневник = diary
дно = bottom
доброволец = volunteer
добродетель = goodness
доверие = trust
довод = argument
догадка = guess
дождь = rain
документ = document
долгота = longitude
долина = valley
доля = share
дом = house, home
домовладение = household
домовой = hobgoblin
дорога = road
доска = board
достаточность = sufficiency
достижение = achievement
достоинство = virtue
доступность = accessibility
дочь = daughter
драгоценность = jewelry
дремота = nap
дрова = firewood
друг = friend
дружба = friendship
дуб = oak
дуга = arc
дым = smoke
дыра = hole
дыхание = breath, respiration
дюжина = dozen
дядя = uncle

еда = food, meal
единица = unit
ежевика = blackberry
езда = drive
ель = fir
ерунда = nonsense

жало = sting
жалоба = complaint
жалость = pity
жара = heat
жасмин = jasmine
жвачка = cud
желание = wish
жена = wife
женщина = woman
жертва = sacrifice
жест = gesture
жестикуляция = gesticulation
жизнь = life
жилет = waistcoat
жираф = giraffe
житель = inhabitant
жонглёр = juggler
жребий = lot
жужжание = buzz
жук = bug
журнал = journal

забор = fence
забота = care
зависимость = dependency
завтра = tomorrow
завтрак = breakfast
загрязнение = pollution
задача = task
задержка = delay
закон = law
законченность = completeness
замена = replacement
замещение = substitution
замок = lock
запас = store
запах = smell
записка = note
запрет = prohibition
запрос = inquiry, query
запутанность = entanglement
заражение = infection
зарождение = inception
зарплата = wage
застёжка = zipper
затея = undertaking
затор = jam
защита = protection
звезда = star
звук = sound
звёздочка = asterisk
здание = building
здоровье = health
зебра = zebra
землевладелец = landowner
землетрясение = earthquake
земля = earth, land
зеркало = mirror
зефир = zephyr
зима = winter
злодей = villain
знак = sign
знакомство = acquaintance
знание = knowledge
значение = signification
значимость = magnitude
зодиак = zodiac
зола = ember
золушка = cinderella
зона = zone
зонтик = umbrella
зоология = zoology
зоопарк = zoo
зрение = sight
зуб = tooth
зубец = cog, jag

игла = needle
игра = game
игрушка = plaything
идеалист = idealist
идея = idea
иерархия = hierarchy
иероглиф = hieroglyph
извещение = notification
извинение = apology, excuse
извлечение = extraction
изготовление = production
излучение = radiation
изменение = alteration, change
измерение = measurement
изобретение = invention
изоляция = isolation
изречение = sentence
изучение = study
иллюзия = illusion
иллюстрация = illustration
импульс = impulse
имя = name
инвентарь = inventory
инвестиция = investment
индивидуализм = individualism
индивидуум = individual
индикатор = indicator
индукция = induction
инерция = inertia
инженер = engineer
инжир = fig
инициатор = initiator
инкогнито = incognito
инкубатор = incubator
иносказание = allegory
инсинуация = insinuation
инспектор = inspector
инструкция = instruction
инструмент = instrument, tool
интеллект = intellect
интендант = quartermaster
интервью = interview
интерес = interest
интуиция = intuition
информация = information
ион = ion
ипподром = hippodrome
искусство = art
исправление = rectification
испытание = trial
исследование = exploration
исследователь = investigator
история = history, story
исчезновение = disappearance
итог = total
ищейка = bloodhound

кабриолет = gig
каламбур = quirk, pun
калейдоскоп = kaleidoscope
календарь = calendar
камень = stone
кампания = campaign
камуфляж = camouflage
канун = eve
капля = drop
карандаш = pencil
карикатура = caricature
карман = pocket
карнавал = carnival
карта = map
картина = picture
карточка = card
категория = category
качество = quality
квадрат = square
квалификация = qualification
кварц = quartz
квота = quota
кенгуру = kangaroo
кепка = cap
кетчуп = ketchup
кивок = nod
кий = cue
кинотеатр = cinema
кислород = oxygen
кит = whale
клавиатура = keyboard
кладовщик = storekeeper
класс = class, classroom
клочок = scrap
клуб = club
ключ = key
книга = book
коврик = mat
кожа = skin
коктейль = cocktail
колебание = oscillation
колесо = wheel
количество = quantity
коллекция = collection
колокол = bell
колонизация = colonization
колчан = quiver
кольцо = ring
команда = command, team
комментарий = comment
коммерция = commerce
комната = room
компания = company
композитор = composer
компромисс = compromise
компьютер = computer
комфорт = comfort
конверт = envelope
кондитер = confectioner
кондитерская = confectionery
конец = end
консерватория = conservatory
консолидация = consolidation
конституция = constitution
консультант = consultant
консультация = consultation
контакт = contact
контейнер = container
контора = office
контраст = contrast
контратака = counterattack
контроль = control
конфедерация = confederation
конфигурация = configuration
конфликт = conflict
конфорка = hob
конфронтация = confrontation
концентрация = concentration
кончик = tip
копия = copy
корабль = vessel
коробка = box
корова = cow
королева = queen
королевство = kingdom
корреспондент = correspondent
косточка = pip
кость = bone
костюм = suit
косуля = roe
кот = cat
котировка = quotation
котёл = cauldron
котёнок = kitten
кофе = coffee
кошмар = nightmare
край = edge
кран = tap
крепость = fortress
крест = cross
крик = scream, shout
криптография = cryptography
критика = criticism
кровать = bed
круг = circle, lap
кружка = mug
крыло = wing
крыса = rat
крыша = roof
ксилофон = xylophone
кувшин = jar
кузнец = blacksmith
куколка = dolly
кулинария = gastronomy
культура = culture
культуризм = bodybuilding
курица = hen
курс = course
кусок = piece
кусочек = bit
куст = bush
кухня = kitchen
куча = pile

лабиринт = labyrinth
лаборатория = laboratory
лагуна = lagoon
ландшафт = landscape
лапа = paw
легенда = legend
лента = tape
лето = summer
лечение = treatment
лига = league
лидер = leader
ликование = exultation
лимонад = lemonade
линия = line
лиса = fox
литература = literature
лифт = elevator, lift
лицо = face
личность = person, personality
лоб = forehead
ловушка = trap
логово = den
лодка = boat
ложь = lie
локоть = elbow
ломтик = slice
лось = elk
луг = meadow, lea
лук = bow
луна = moon
луч = ray
любимец = pet
любитель = amateur
любовь = love
люди = people
люстра = chandelier
лёд = ice
лётчик = aviator

магазин = shop
магнит = magnet
май = may
малина = raspberry
мальчик = boy
манекен = dummy
манера = manner
манифестация = manifestation
манёвр = manoeuvre
маргаритка = daisy
марш = march
масло = oil, butter
масса = mass
математика = mathematics
материал = material
мать = mother
махинация = machination
машина = machine
маяк = lighthouse
мебель = furniture
медальон = locket
медведь = bear
медсестра = nurse
мелодия = melody, tune
мельник = miller
мемуары = memoir
мера = measure
место = place
месть = vengeance
месяц = month
метафизика = metaphysics
метеор = meteor
метеорология = meteorology
метка = mark
метод = method
методология = methodology
метрополитен = underground
мех = fur
механика = mechanics
мечта = dream
мешанина = patchwork
миг = moment
микробиология = microbiology
микрофон = microphone
миллионер = millionaire
минута = minute
мир = peace, world
мираж = mirage
мишень = target
младенец = baby
мнение = opinion
множество = multitude
мода = fashion, vogue
модель = model
можжевельник = juniper
мозг = brain
молния = lightning
молодёжь = youth
монастырь = monastery
монашка = nun
мопс = pug
море = sea
мост = bridge
мотив = motive
мрамор = marble
муж = husband
мужчина = man
музыка = music
муравей = ant
мускул = muscle
мусор = rubbish
муха = fly
мысль = thought
мытьё = wash
мычание = moo
мышеловка = mousetrap
мышление = mentality
мяуканье = mew

наблюдение = observation, surveillance
набор = set
навык = skill
наглость = insolence
надежда = hope
надзор = supervision
надувание = inflation
надёжность = reliability
назначение = assignment
назойливость = importunity
наказание = punishment
наклейка = sticker
накопление = accumulation
налог = tax
намерение = intention, purpose
нападение = onslaught
напиток = drink
направление = direction
народ = nation
нарушение = infringement, contravention
наследие = heritage
наследник = inheritor
наследница = heiress
наследство = inheritance, legacy
настойчивость = perseverance
настроение = mood
натиск = onrush
наука = science
начало = beginning
небо = sky
невежда = ignoramus
невежество = ignorance
невинность = innocence
неделя = week
недоверие = incredulity
недоумение = bewilderment
независимость = independence
неизменность = immutability
нейтралитет = neutrality
неосязаемость = impalpability
неприятность = trouble
нерв = nerve
несхожесть = dissimilarity
нетерпение = impatience
неуверенность = incertitude
неудобство = inconvenience
нефть = petroleum
новичок = novice
новость = news
нога = leg, foot
ноль = zero
нос = nose
ночь = night
нрав = temper
нутро = gut

обвинение = blame
обед = dinner, lunch
обет = vow
обещание = promise
область = area, region
облегчение = relief, facilitation
обмен = exchange
ободрение = encouragement
обои = wallpaper
оборудование = equipment
образ = image
образование = education
обращение = appeal
обсерватория = observatory
общительность = joviality
объединение = incorporation
объяснение = explanation
объятие = hug
обычай = custom
обязанность = duty
обязательство = obligation, commitment
овощ = vegetable
овёс = oat
огонь = fire
ограничение = restriction
одежда = apparel, clothes
одержимость = obsession
одеяло = quilt
одобрение = approval
океан = ocean
окно = window
окружность = circumference
опасность = danger, jeopardy
операция = operation
описание = description
оползень = landslide
оппонент = opponent
оправа = rim
оправдание = justification
определение = definition, determination
оптимизация = optimization
опыт = experience
организация = organization
орех = nut
оркестр = orchestra
оружие = weapon
орфография = orthography
орёл = eagle
оса = wasp
освещение = illumination
освобождение = liberation
осень = autumn
оснастка = rig
основа = basis
особенность = feature, particularity
остановка = stop
остаток = remainder
острие = nib
остров = isle
осуществление = realization
ось = axis
ответ = answer, reply
отдел = department
отдых = rest
отец = father
отклонение = rejection
открытие = discovery
отмена = cancellation
отношение = attitude, relation
отпрыск = offspring
отпуск = vacation
отрасль = industry
отставание = lag
отсутствие = absence
оттенок = hue, shade
отчизна = fatherland
отчёт = report
охрана = guard, safeguard
очерк = essay
ошибка = error, mistake
ощущение = feeling

падчерица = stepdaughter
палеонтология = paleontology
палец = finger
палка = stick
пальто = coat
память = memory
паникёр = scaremonger
папа = dad
пар = steam, vapor
пара = pair, couple
параграф = paragraph
парашют = parachute
парень = guy
пари = bet
парикмахер = hairdresser
партия = party
партнёр = partner
партнёрство = partnership
пассажир = passenger
пауза = pause
паутина = web
пацан = kid
перевод = translation
переводчик = interpreter
перевозка = transport
переговоры = negotiation
передача = transmission
передвижение = movement
перерыв = break, interruption
переучёт = stocktaking
период = period
перо = quill
персонал = personnel
перспектива = perspective
перфорация = perforation
песня = song
печать = print
пинок = kick
пирог = pie
писатель = writer
питание = nutrition
плавник = fin
план = plan
пластмасса = plastic
плата = charge
платформа = platform
платье = dress
платёж = payment
плач = cry
плед = rug
племянник = nephew
плечо = shoulder
плющ = ivy
побег = escape
победа = victory
поведение = behavior
поверхность = surface
повествование = narration
повесть = narrative
повидло = marmalade
поворот = turn
повреждение = damage
погода = weather
погружение = dip
подарок = present, gift
подбородок = chin
подвал = basement
подготовка = preparation
подкладка = pad
подкова = horseshoe
подлинность = originality
подмастерье = apprentice
подписка = subscription
подражание = imitation
подсказка = clue
подтверждение = confirmation, corroboration
подход = approach
поезд = train
поездка = trip
пожертвование = donation
позитивность = positiveness
поиск = search
показ = display
поколение = generation
покрытие = cover
покупка = buy
полдень = noon, midday
поле = field
политика = politics
полицейский = cop
полиция = police
половина = half
полоса = band
полуостров = peninsula
получатель = recipient
полушарие = hemisphere
польза = utility
полёт = flight
помощь = aid
понимание = understanding
пончик = doughnut
поощрение = stimulation
поправка = correction
попытка = attempt
порез = cut
порог = doorstep
порт = port
портфель = portfolio
порядок = order
посетитель = visitor
посещение = visit
посланец = envoy
посол = ambassador
постижение = comprehension
постоянство = persistence
поток = flow
потомок = descendant
потребитель = consumer
почва = soil
почка = kidney
почта = mail, post
появление = appearance
пояс = belt
правда = truth
правило = rule
правительство = government
право = right
правосудие = justice
праздник = holiday
практика = practice
превосходство = excellence, preponderance
преданность = dedication
предвестник = forerunner, harbinger
предвидение = precognition
предвкушение = anticipation
предел = limit
предложение = suggestion, offer
предмет = object
предок = ancestor
предположение = assumption, presumption
предсказатель = oracle
представление = performance, presentation
предубеждение = preconception
предчувствие = premonition
президент = president
преимущество = advantage
препятствие = obstruction
пресса = press
претензия = claim
преувеличение = exaggeration
прибыль = profit
прибытие = arrival
приветствие = greeting
привратник = janitor
привычка = habit
приглашение = invitation
пригоршня = handful
приз = prize
признание = confession
прикосновение = touch
приманка = decoy, bait
пример = example
примечание = remark
принцип = principle
принятие = acceptance
приоритет = priority
природа = nature
притяжение = attraction
причина = reason, cause
приятель = pal
проблема = problem, challenge
проблеск = glimpse
проверка = verification, check
проволока = wire
прогноз = forecast
прогресс = progress
прогулка = walk
продажа = sale
проект = project
производство = manufacture
произношение = pronunciation
происхождение = origin
происшествие = incident
промах = miss
прорыв = breakthrough
просветление = enlightenment
прославление = glorification
пространство = space
противник = foe
противоречие = contradiction
профессорство = professorship
проход = passage
процент = percentage
процесс = process
прут = rod
прыжок = jump
пряжа = yarn
психолог = psychologist
птица = bird
публика = public
публикация = publication
пупок = umbilicus
пустота = void
путешествие = travel, journey
путь = way
пчела = bee
пшеница = wheat
пьеса = play
пятно = spot

работа = work, job
равенство = equality
равновесие = balance
радио = radio
радиовещание = broadcasting
радость = joy
развлечение = entertainment
разговор = conversation
разложение = decomposition
размер = size
размещение = accommodation
размыкание = disconnection
разница = difference
разногласие = issue
разнообразие = variety
разрешение = permission, authorization
разумность = rationality
район = district
рамка = frame
раса = race
раскопки = dig
расписание = schedule, timetable
расположение = position, arrangement
распределение = allocation, dispensation
расслабление = relaxation
расследование = investigation
рассмотрение = consideration
расстояние = distance
растение = plant
реакция = reaction
ребро = rib
ребёнок = child
реверберация = reverberation
регистратура = reception
регистрация = registration
регулировка = adjustment
резиденция = residence
результат = result
реклама = advertisement
рекорд = record
реставрация = restoration
ретроспектива = retrospection
реформа = reformation
речь = speech
решение = decision
риск = risk
рисование = drawing
род = kin
родственник = relative
родство = relationship
рождение = birth
рождество = xmas
рожь = rye
роса = dew
роскошь = luxury
рот = mouth
ртуть = quicksilver
рубец = hem
руда = ore
ружьё = gun
рука = hand, arm
рукавица = mitten
рукоделие = handicraft
рукопись = manuscript
рукопожатие = handshake
ручка = pen
рынок = market
рыцарство = knighthood
рыцарь = knight
ряд = row, range

саксофон = sax
самец = male
самка = female
самоанализ = introspection
самолёт = aircraft
самоцвет = gem
сапог = boot
сатисфакция = satisfaction
сборище = mob
свадьба = wedding
свекла = beet
свет = light
свист = zip
свисток = whistle
свобода = freedom
свод = vault
связь = communication
сгиб = ply
сделка = deal
сдоба = muffin
сегодня = today
сезон = season
сейф = safe
секрет = secret
секретарь = receptionist
секунда = second
секция = section
семья = family
сено = hay
сердце = heart
середина = middle
сестра = sister
сеть = net
сиденье = seat
сила = force, power
сингулярность = singularity
система = system
ситуация = situation
сказочник = storyteller
скачок = hop
скит = hermitage
склонность = inclination
скобка = parenthesis
сковорода = pan
скорость = speed, velocity
скрипка = violin
скульптура = sculpture
следопыт = pathfinder
слесарь = locksmith
словарь = dictionary, vocabulary
слово = word
сложность = complication
слон = elephant
служба = service
случай = case, occasion
слякоть = mud
смекалка = ingenuity
смесь = mix
смета = estimate
смех = laugh
смешивание = mixture
смущение = embarrassment
смысл = meaning
снаряжение = outfit, kit
снег = snow
сноровка = proficiency
снос = demolition
собрание = meeting, congregation
событие = event
сова = owl
совершенство = perfection
совет = advice
советник = counsellor
совместимость = compatibility
соглашение = agreement
содействие = assistance
содержание = content
соединение = connection
созвездие = constellation
создание = creature
созерцание = contemplation
сознание = consciousness
сойка = jay
сок = juice
сокращение = reduction
соловей = nightingale
сомнение = hesitation, doubt
сон = sleep
сообщение = message
сообщество = community
сопло = nozzle
сопоставление = juxtaposition
сорт = sort, kind
сосед = neighbor
соседство = neighborhood
состояние = state
сострадание = compassion
софт = software
сохранение = conservation
сочетание = combination
союз = union
союзник = ally
спасение = salvation
спецификация = specification
спешка = rush
спина = back
список = list
спичка = match
спокойствие = placidity, tranquility
спорт = sport
спортзал = gym
способность = ability
справочник = manual
сравнение = comparison
срок = term
срочность = urgency
стабилизация = stabilization
ставка = rate
стадия = stage
стадо = drove
стандарт = standard
старт = start
старшекурсник = undergraduate
статья = article
стекло = glass
стена = wall
степень = grade
стиль = style
стих = verse
стог = mow
стоимость = cost, worth
стол = table
столица = capital
сторона = side
страж = guardian
страна = country
странность = oddity, peculiarity
странствие = peregrination
стратосфера = stratosphere
страх = fear
страхование = insurance
стремянка = ladder
строительство = construction
струна = string
стручок = pod
струя = jet
стук = knock
стыд = shame
субординация = subordination
судья = judge
суеверие = superstition
суждение = judgement
сумка = bag
сумочка = handbag
супермаркет = supermarket
схватка = grapple
схема = scheme
сцена = scene
счастье = happiness
счёт = bill, account
счётчик = counter

тайна = mystery
талисман = mascot
танец = dance
тарелка = plate
телевидение = television
телескоп = telescope
телефон = phone, telephone
тело = body
тема = subject
темнота = darkness
температура = temperature
тень = shadow
тест = test
тесто = dough
тип = type
толпа = crowd
тон = tone
топор = axe
торговля = trade
точка = dot, point
точность = accuracy
традиция = tradition
трактир = pub
транскрипция = transcription
транспорт = vehicle
требование = requirement
трепет = trepidation
треска = cod
тригонометрия = trigonometry
тропинка = track, path
труба = pipe
трудность = difficulty
тряпка = rag
туман = fog
тупик = deadlock
тысячелетие = millennium
тётя = aunt

убеждение = belief, conviction
убежище = shelter
уважение = respect, regard
уверенность = confidence
угол = corner
угроза = menace
удар = hit, strike
удача = luck
удивление = surprise, astonishment
удовольствие = pleasure
узел = hub
узнаваемость = recognition
укол = jab
украшение = decoration
укрепление = reinforcement
укус = bite
улица = street
улучшение = improvement
улыбка = smile
ультиматум = ultimatum
ультрамарин = ultramarine
ультрафиолет = ultraviolet
умиротворение = pacification
умысел = premeditation
университет = university
униформа = uniform
уныние = melancholy
употребление = usage
управление = management
упражнение = exercise
упрямство = pertinacity
упрёк = objurgation
уравнение = equation
ураган = hurricane
урбанизация = urbanization
уровень = level
урок = lesson
усвоение = assimilation
усиление = amplification
усилие = effort
ускорение = acceleration
условие = condition
успех = success
установка = installation
устрица = oyster
усы = moustache
утверждение = statement, proposition
утро = morning
ухо = ear
участник = member, participant
ученик = pupil
учреждение = institution, establishment
ущерб = waste
уязвимость = vulnerability

фабрика = factory
файл = file
факт = fact
фармакология = pharmacology
фасоль = bean
федерация = federation
ферментация = fermentation
фестиваль = festival
фея = fay
фигура = figure
филантропия = philanthropy
филиал = branch
филолог = philologist
фильм = film
фисташка = pistachio
флагман = flagship
фламинго = flamingo
флюгер = weathercock
фойе = lounge
фон = background
фонтан = fountain
форма = form, shape
фортификация = fortification
фотография = photography
фрагмент = fragment
фрагментация = fragmentation
фундамент = foundation
фургон = wagon

характер = character, mettle
хижина = hut
хитрость = trick
хлеб = bread
ход = move
хозяин = master
хозяйка = hostess
холодильник = refrigerator
холостяк = bachelor
хомяк = hamster
хранитель = keeper

цвет = color
цветение = efflorescence
цветоводство = floriculture
целостность = integrity
цель = aim, objective
цена = price
ценность = value
центр = center
церковь = church
цивилизация = civilization
цитата = quote
цифра = digit

чайник = kettle
час = hour
часть = part
чаша = bowl
чашка = cup
чек = cheque
человек = human
человечество = humanity
челюсть = jaw
чемпион = champion
черника = bilberry
чернила = ink
черновик = draft
честность = honesty
честолюбие = ambition
четверть = quarter
чин = rank
число = number
чувство = sense
чудо = marvel

шаблон = pattern
шаг = step, footstep
шанс = chance
шар = ball
шарнир = knuckle
шахта = mine
швабра = mop
шедевр = masterpiece
шеф = chief
шефство = patronage
шея = neck
шишка = nob
шкала = scale
школа = school
шляпа = hat
шок = shock
шоссе = highway
шоу = show
штамп = stamp
шторм = storm
штрейкбрехер = strikebreaker
штурман = navigator
шум = noise, uproar
шутка = joke

щедрость = munificence
щека = cheek
щенок = pup
щипок = nip
щипцы = nipper
щётка = brush

эвакуация = evacuation
экзамен = exam
экскурсия = tour
эксперимент = experiment
эксплуатация = maintenance
элегантность = elegance
эльф = elf
эмоция = emotion
энергия = energy
энтузиаст = enthusiast
энциклопедия = encyclopedia
эпиграф = epigraph
эпоха = epoch
эра = era
эрудиция = scholarship
эстет = aesthete
эстетика = aesthetics
этаж = floor
эффект = effect
эффективность = efficiency

юбилей = jubilee
юбка = skirt
ювелир = jeweller
юнец = youngster
юноша = lad

явление = happening
ядро = kernel
язык = language, tongue
языковедение = linguistics
яйцо = egg
яма = pit
ярлык = label
яхта = yacht
ящерица = lizard

